7060	BACONSAVER
7AAA	KYRTO
7FFF	FEMALE DARK
99DD	:B:
9BF9	C
B9BB	G
BAAA	WEIRDGRAPE
BFFF	MOONCAKE
CDFF	MALE FLYING
CEFF	PSNBERRY
CFFF	MALE GROUND
DCFF	MALE ROCK
DDDD	LILAC
DDFF	MALE BUG
DEFF	MALE GHOST
DFFB	S
ECFF	MALE FIRE
EDFF	SEXLESS WATER
EEFF	MALE GRASS
EFFF	MALE ELECTRIC
FAAA	MALE/SEXLESS SHINY DARK
FDFF	MALE/SEXLESS ELECTRIC
FFFF	MALE/UNISEX DARK
